 *************       *************         ************      ************     ***********
*                   *                      *          *      *          *     *         *
*                   *                      *          *      *          *     *         *
*                   *                      ************      *          *     *         *
*                   *                      *                 ************     *         *
*         ******    *         ******       *************     ***              *         *
*            *      *            *         *           *     *  ***           *         *
*            *      *            *     #   *           *     *     ***        *         *
 *************       *************    ##   *************     *        ***     ***********