**************    *************     *************     **          
**************    *************     *************     **          
**                **         **     **         **     **          
**                **         **     **         **     **          
**                **         **     **         **     **          
**                **         **     **         **     **          
**                **         **     **         **     **          
**************    *************     *************     ************
**************    *************     *************     ************                       
                                                                  
          *          *                *            ***     **    
         ***        ***              ***           ****    **    
        ** **      ** **            ** **          ** **   **    
       **   **    **   **          **   **         **  **  **    
      **     **  **     **        *********        **   ** **    
     **       ****       **      **       **       **    ****    
    **         **         **    **         **      **     ***    