Width: 30     Height: 13
##############################
#S...........................#
#*...........................#
#*****..........*********....#
#....*..........*.......*....#
#....*..........*.......*....#
#....*..........*.......*....#
#....**********.*.......*....#
#.............***.......***..#
#.........................*..#
#.........................*..#
#.........................*F.#
##############################
